yes=Si
no=No

user=Username
pass=Password
signIn=Login
signUp=Iscriviti
passForg=Problemi di accesso?
memoCred=Memorizza le credenziali

menu=Menu
home=Home
incarichi=Incarichi

profile=Profile
recuperaPass=Recupera password

jobDesc=Descrizione
jobAtch=Allegati
jobSpre=Sprenota incarico
jobDate=Cambia data
jobCont=Continua compilazione
jobTick=Apri un ticket

timerStart=Start tempo
timerStop=Stop tempo

rifNum=Riferimento
verIni=Inizio verifica
verEnd=Fine verifica

learning=Vai al learning
kpiInit=Compila incarico
kpiCont=Continua compilazione
cancel=Annulla

jobStarted=Sei riuscito a svolgere l'incarico?
jobNotDone=Inserisci il motivo per cui non hai potuto svolgerlo
jobStartTime=Inserisci data e ora di inizio dell'incarico
jobSelAtch=Seleziona allegati

question=Domanda
instruct=Istruzioni
insertText=Inserisci un testo
atchRemove=Cancello l'allegato?

note=Note
back=Indietro
next=Avanti
lastPage=Invia il questionario

error=Errore
noValue=Selezionare un valore
noNotes=Inserire una nota
noAttch=Inserire un allegato
uploadPic=Upload da:
picFromCam=Scatta una foto
picFromGal=Allega dalla galleria

jobFinal=Commento finale
jobFinalTime=Ora di fine esecuzione
readyToSend=Pronto per l'invio

